1111111111111111111111111
1111111111121211111111111
1000000000000000000000001
1010000011100000111000001
1010101000100100001000001
1010010011101110111000001
1010101000100100100000001
1010000011100000111000001
1000000000000000000000001
1011101000000010111000001
1000101000000100001000001
1011101110001000111000001
1010001010010000100000001
1011101110100000111000001
1000000000000000000000001
1000111111111100000000001
1000100000000000000000001
1000101010111001000100001
1000101010101011100100001
1010101110111001000100001
1001100010001000000100001
1000100010111000000100001
1111111111111111111111111