1111111111111111111111111
1111111111121211111111111
1111111100000000100001001
1111011100000000100011001
1111101100111000100011001
1000000100010000100111001
1111101100010000111111101
1111011100111000111111101
1111111100000000111111111
1111111111111111111111001
1111111000000000011111011
1111111100001000011111001
1111111000000000011111101
1111110000001000000001001
1110000000000000000001001
1110000000001000100001001
1110000000000000000001001
1110000010001000100011001
1110000000000000000100001
1110000010001000100010001
1110000000000000000010011
1100000000000000000010001
1111111111111111111111111